





NO textures/north.xpm
SO textures/south.xpm
WE textures/west.xpm
EA textures/east.xpm

F 164,169,20
C 153,204,255

111111111111111111111
101000001000000000001
101010101011111110001
100010100010000010001
111110101111101011101
10000010100N101000001
101111101010101111111
101000001010100000101
101110101010101010101
100000101010000010001
111111101011111011101
100000101000100010001
101011111111111010101
100010000000000010001
101010111011111111101
101000001000000000001
111111111111111111111

